64x48
LLWWWLLLLLLLLLLLLLLLWWWWLLLLLLLWWWLLLLLLLLLLLLLLLLLWWWWLLLLLLLLL
LWWWWWLLLLLLLLLLLLLLWWWWLLLLLLWWWLLLLLLLLLLLLLLLLLLLWWWLLLLLLLLL
LWWWWWWLLLLLLLLLLLLLWWWWLLLLLWWWWLLLLLLLLLLLLLLLLLLLWWWLLLLLLLLL
LWWWWWWLLLLLLLLLLLLLLWWWLLLLWWWWWLLLLLLLLLLLLLLLLLLLWWWWLLLLLLLL
LWWWWWLLLLLLLLLLLLLLLWWWLLLLWWWWLLLLLLLLLLLLLLLLLLLLWWWWWLLLLLLL
LWWSSSLLLLLLLLLWWLLLLLWLLLLLLWWLLLWWWWWLLLLLLLLWWLLLLWWWWLLLLLLL
LWWSSSLLLLLLLLWWWWLLLLLLLLLLLLSSSWWWWWWWLLLLLLWWWWLLLWWWWWLLLLLL
LWWWSLLLLLLLLLSSSWLLLLLLLLLLLLSSSSSSWWWWWWLLLLWWWWLLWWWWWWLLLLLL
LWWWWLLLLLLLLSSSSSLLLLLLLLLLLLSSSSSSWWWWWWWLLLWWWLLSWWWWWWLLLLLL
LLWWWWLLLLLLLSSSSSLLLLLLLLLLLLLSSSSSWWWWWWWLLLWWWLSSLWWWWWLLLLLL
LLLWWWWLLLLLLLSSSLLLLLLLLLLLLLLLSSSWWWWWWWWWLLLWWWSSLLWWWWLLLWLL
LLLLWWWWLLLLLLLLLLLLLLLLLLLLLLLLLWWWWWWWWWWWWLLWWSSWLLWWWLLLWWLL
LLLLWWWWWLLLLLLLLLLLLLLLLLLLLLLLLLLLWWWWWWWWWLLWWWWWWWWWWWWWWWLL
LLLLLWWWWWLLLLLLLLLLLLLLLLLLLLLLLLLLLWWWWWWWLLWWWWWWWWWWWWWWWWWL
LLLLLLLWWWLLLLLLLLLLLLLLLLLLLLLLLLLLLWWWWWWLLLWWWWWWWWWWWWWWWWWW
LLLLLLLLWWLLLLLLLLLLLLWWWLLLLLLLLLLLWWWWWWWLLLLWWWWWWWWWWWWWWWWW
LLLLLLLLWWWLLLLLLLLLLWWWWWWWLLLLLLLWWWWWWWWWLLLLLLWWWWLLLLWWWWWW
LLLSSLLLLWWWWLLLLLLLLLWWWWWWWLLLLLLLLLWWWWWWWLLLLLLWWLLLLLLWWWWL
LLSSSLLLLWWWWWLLLLLLLLLWSWWWWLLLLLSSSLLWWWWWWWLLLLLWWLLLLLLLWWLL
LSSSSLLLWSSWWWLLLLLLLLLSSWWWLLLLLLSSSSSLLLWWWLLLLLWWWLLLSLLLLLLL
LSSSSSLWSSSSWLLLLLLLLLLSSLLLLLLLLLSSSSLLLLLLLLLLLWWWLLLLLLLLLLLL
LLSSSSWWSSSSLLLLLLSSLLLLLLLLLLLLWWSSSLLLLLLLLLLLWWWLLLLLLLLLLLLL
LLLLSLWWWSSSLLLLLLSSLLLLLLLLLLLWWSSSLLLLLLLLLLLLWWWLLLLLLLLLLLLL
LLLLLLWWWWSSLLLLLLSSLLLLLLLLLLLWSSSSLLLLLLLLLLLWWWWWLLLLLLLLLLLL
WLLLLLWWWLLLLLLLLSSLLLLLLLLLLLLSSSSLLLLLLLLLLLLWWWWWWWWWLLLLLWWW
WLLLLLLLLLLLLLLSSSSLLLLLLLWWLLLLLWLLLLLWLLLLLLWWWWWWWWWWWWWWWWWW
LLLLLLLLLLLLLLSSSSSLLLLLLLWWWLLLLLLLLLWWWLLLLWWWWWWWWWLLWWWWWWWW
LLLLLLLLLLLLLLSSSSSLLLLLLLWWWLLLLLLLLLLWLLLLWWWWWWWWWWLLLWWWWWWL
LLLLLLLLLLLLLSSSSSSSLLLLLLLWLLLLLLLLLLLLLLLLWWWWWWWWWWLLLWWWWWLL
LLLLLLLLLLLLLLLLLLSSLLLLLLLLLLLLLLLLLLLLLLLLWWWWWWWWWWLLLWWWWLLL
LLLLLLLLLLLLLLLLLLWWLLLLLLLLLLLLLLLLLLLLLLLLWWWWWWWWWLLLLWWWLLLL
LLLLLSSLLLLLLLLLLLWWWLLLLLLLLLLLLLLLLLLLLLLWWWWLLLLLLLLLLLLLLLLL
LLLLSSSLLLLLLLLLLLWWWWWWWLLLLLLLLLLLLLLLLLWWWWWLLLLLLLLLLLLLLLLL
LLWWWSLLLLLLLLLLLLLWWWWWWLLLLLLLLLLLLLLLLWWWWWWLLLLLLLLLLLLLLLLL
LLWWWWWLLLLLLLLLLLLLWWWWLLLLLLLLLLLSSSSSLWWWWWWLLLLLLLLLLLLWWWLL
LLLWWWLLLLLLLWLLSLLLLLLLLLLLLLLLLLLLSSSSSLWWWWLLLLLLLLLLLLLWWWWL
LLLLLLLLLLLLWWWSSSLLLLLLLLLLLLLLLLLLLSSSSLLLLLLLLLLLLWWLLLLWWWWL
LLLLLLLLLLLWWWWSSSLLLLLLSLLLLLLLLLLLLLSSSLLLLLLLLLLLLWWWLLLWWWWL
LLLLLLLLLWWWWWWSSSLLLLLSSLLLLLLLLLLLLLLLLLLLLLLLLLLLLWWWLLLLWWWL
LLLLLLLLWWWWWWWWWWWWLLLSSLLLLLLLLLLLLLLLLLLLLLLLLLLLLLWLLLLLLWWW
LLLLLLLLLWWWWWWWWWWWWLLSSLLLLLLLLLLLLLLLLLLLLLLLLLLLLLLLLLLLLLWL
LLLLLLLLLLLLWWWLLLWWWLLLLLLLLLLLLLLLLLLLLLLLLLLLLLLLLLLLLLLLLLLL
LLLLLLLLLLLLLLLLLLLLLLLLLLLLLLLLLLLLLLLLLLLLLLLSSLLLLLLLLLLLLLLL
LLLLLLLLLLLLLLLLLLLLLLLLLLLLLLLLLLLLLLLLLLLLLLLLLLLLLLLLLLLLLLLL
LLLLLLLLLLLLLLLLLSLLLWWWWLLLLLLLLLLLLWWLLLLLLLLLWWWLLLWLLLLLLLLL
LLLLLLLLLLLLLLLLSSLLWWWWWLLLLLLLLLLLWWWWLLLLLLLWWWWWWWWWLLLLLLLL
LLLLLLLLLLLLLLLLLLLWWWWWWLLLLLLLLWWWWWWWLLLLLLLWWWWWWWWWLLLLLLLL
LLLWLLLLLLLLLLLLLLLWWWWWWLLLLLLLWWWLLWWLLLLLLLLLWWWWWWWWLLLLLLLL
